NO ./textures/bluestone.xpm
SO ./textures/greystone.xpm
WE ./textures/purplestone.xpm
EA ./textures/redbrick.xpm
R 840 640 
S ./textures/pillar.xpm
F 00,153,15
C 255,255,255

        1111111111111111111111111
        1000000000000000000000001
        1100000000000200000000001
        1000020000000000000000001
111111111000000000000200000000001
100000000000000000000000000001111
10002000002000W10000000000001
10000000000000000000000000001
10000000000000002000020000001
10000000000000000000000000001
10000000000000000001010000001
11000001110101011111011110101
11110111 1110101 101111010001
11111111 1111111 111111111111
